
F 220,100,0



NO ./path_to_the_north_texture
EA ./path_to_the_east_texture

C 225,30,0

SO ./path_to_the_south_texture
WE ./path_to_the_west_texture



        1111111111111111111111111111
           1000000000110000000000001
         11100000111000000000000111
        1001000000000000000000001
 11111111011000001110000000000001
10000000001100000111011111111111
111110111111111011100000010001
11110111111000011101010010001
1100000011010101110000001000111
10000000000000001100000010001
10000000000000001101010010001
11000001110101011111011110N0111
11110111 1110101 101111010001
11111111 1111111 111111111111
